....................
.....###########....
...............#....
...............#....
....................
....................
....................
....................
....................
.........###........
....................
.........$..........
....................
....................
....................
.#..................
.#..................
.##.................
....................
..................##