....................
.....###########....
...............#....
...............#....
....................
....................
....................
....................
.........#..........
........###.........
....................
....................
....................
....................
....................
.....##########.....
....................
....................
....................
....................